#########################
####......#####....######
###.........###.....#####
##....#......###....#####
##...###......##.....####
##..######....##......###
##..######....###.....###
#...########..#####....##
#....#######..######...##
#....#####.......###....#
##...####...#.....##....#
###........######.###...#
###.......##......###...#
###...#..###.########...#
##...#######.......###..#
#....#############.#....#
#.....####.###.....##..##
#.........########.....##
##...##############....##
###...###..###.######..##
###.......##....####...##
####.#####......###...###
#..###................###
#..................######
#########################
