{
    "name" : "test",
    "layout" : [
        "#########################",
        "####......#####....######",
        "###.........###.....#####",
        "##....#......###....#####",
        "##...###......##.....####",
        "##..######....##......###",
        "##..######....###.....###",
        "#...########..#####....##",
        "#....#######..######...##",
        "#....#####.......###....#",
        "##...####...#.....##....#",
        "###........######.###...#",
        "###.......##......###...#",
        "###...#..###.########...#",
        "##...#######.......###..#",
        "#....#############.#....#",
        "#.....####.###.....##..##",
        "#.........########.....##",
        "##...##############..####",
        "###...###......##########",
        "###.......##....####...##",
        "###########.....###...###",
        "#..###................###",
        "#..................######",
        "#########################"
    ],

    "tunnels" : [
        {
            "name"      : "a",
            "coord"     : [16,0],
            "map"       : "test2",
            "to_tunnel" : "b"
        }
    ]
}
